اُتنا	اُتْنَا	ADJ
اُتنی	اُتنی	ADJ
اُتنے	اُتنے	ADJ
اِدھر	اِدھَر	HRF
اُدھر	اُدھَر	HRF
اُس	اُس	PRN
اکاون	اِکاوَن	ADJ
اُن	اُن	PRN
اُنھوں	اُنھوں	PRN
اُنہوں	اُنہوں	PRN
اٹھئے	اُٹھئے	VB
اٹھتا	اُٹْھتا 	VB
اٹھتیں	اُٹْھتِیں 	VB
اٹھتے	اُٹْھتے 	VB
اٹھنے	اُٹْھنے 	VB
اٹھو	اُٹھو 	VB
اٹھوں	اُٹھُوں 	VB
اٹھی	اُٹھی 	VB
اٹھیں	اٹھیں	VB
اٹھے	اُٹھے 	VB
آدھے	آدھے	ADJ
آٹھویں	آٹھویں	ADJ
بارھواں	بارھْواں	ADJ
بارھویں	بارھْویں	ADJ
بشرطےکہ	بَشَرْطیکِہ	HRF
بیٹھ	بَیٹْھ 	VB
بیٹھئے	بَیٹْھئے	VB
بیٹھتا	بَیٹْھتا 	VB
بیٹھتی	بَیٹْھتِی 	VB
بیٹھتیں	بَیٹْھتِیں 	VB
بیٹھتے	بَیٹْھتے 	VB
بیٹھو	بَیٹھو 	VB
بیٹھی	بَیٹھی 	VB
بیٹھیں	بَیٹھیں 	VB
بیٹھے	بَیٹھے 	VB
پائیے	پائیے	VB
پاتیں	پاتِیں	VB
پانے	پانے	VB
پونے	پَونے	ADJ
پڑو	پَڑو 	VB
پڑے	پَڑے 	VB
پیتا	پِیتا 	VB
پیتی	پِیتی 	VB
پیتیں	پِیتِیں 	VB
پیتے	پِیتے 	VB
پیجئے	پِیجِیے 	VB
پنتالیس	پَینْتالِیس	ADJ
پینے	پِینے 	VB
پیؤ	پِیو 	VB
پیؤں	پِیُوں 	VB
پیئیں	پِییں 	VB
پیئے	پِیے 	VB
تگنے	تِگُنے	ADJ
تمھیں	تُمھیں 	PRN
تمہاری	تُمْہاری	PRN
تمہارے	تُمْہارے	PRN
تھیں	تھِیں	VB
تیرے	تیرے	PRN
جاؤ	جاؤ	VB
جاؤں	جاؤُں	VB
جائیں	جائیں	VB
جائیے	جائِیے 	VB
جاتیں	جاتِیں	VB
جاتے	جاتے	VB
جانے	جانے	VB
جنھوں	جِنھوں	PRN
چاہا	چاہا	VB
چاہو	چاہو	VB
چاہی	چاہِی	VB
چاہئے	چاہْیے 	VB
چکتیں	چُکْتِیں	VB
چکوں	چُکُوں	VB
چکیں	چُکِیں	VB
چکئے	چُکیے	VB
چکے	چُکے	VB
چلنے	چَلْنے 	VB
چلوں	چَلُوں 	VB
چلیں	چَلِیں 	VB
چلئے	چَلْیے 	VB
چلے	چَلے 	VB
چھٹے	چَھٹے 	ADJ
دوں	دُوں	VB
دی	دِی	VB
دیتا	دیتا	VB
دیتی	دیتِی	VB
دیتیں	دیتِیں	VB
دیتے	دیتے	VB
دیجئے	دیجئے	VB
دینے	دینے	VB
دیں	دِیں	VB
رکھتا	رَکْھتا 	VB
رکھتی	رَکْھتی 	VB
رکھتیں	رَکْھتِیں 	VB
رکھتے	رَکْھتے 	VB
رکھنی	رَکْھنی 	VB
رکھنے	رَکْھنے 	VB
رکھو	رَکّھو 	VB
رکھوں	رَکّھُوں 	VB
رکھی	رَکّھی 	VB
رکھیں	رَکّھیں 	VB
رکھئے	رَکْھیے 	VB
رکھے	رَکّھے 	VB
رہتی	رَہْتی 	VB
رہنی	رَہْنی 	VB
رہوں	رَہُوں 	VB
رہئے	رَہْیے 	VB
ساتویں	ساتوِیں	ADJ
سرسٹھ	سَرْسَٹھ	ADJ
سکا	سَکا	VB
سکتیں	سَکْتِیں	VB
سکو	سَکو	VB
سکی	سَکی	VB
سکئے	سَکْیے	VB
سکے	سَکے	VB
سولھواں	سولھْواں	ADJ
سولھویں	سولھْوِیں	ADJ
سہی	سَہِی	HRF
سینکڑوں	سَینْکْڑوں	ADJ
کرتیں	کَرْتِیں 	VB
کرتے	کَرْتے	VB
کرنے	کَرْنے	VB
کروں	کَرُوں	VB
کریں	کَریں 	VB
كسے	کِسے	PRN
کنھوں	کِنھوں	PRN
کنہوں	کِنہوں	PRN
کیلیے	کیلِیے	HRF
کےلیے	کےلِیے	HRF
گئیں	گَئِیں 	VB
گزرتا	گُزَرْتا 	VB
گزرتی	گُزَرْتی 	VB
گزرتیں	گُزَرْتِیں 	VB
گزرتے	گُزَرْتے 	VB
گزرنی	گُزَرْنی 	VB
گزرنے	گُزَرْنے 	VB
گزروں	گُزْرُوں 	VB
گزریں	گُزْریں 	VB
گزرئے	گُزَرْیے 	VB
لیتا	لیتا	VB
لیتی	لیتِی	VB
لیتیں	لیتِیں 	VB
لیتے	لیتے 	VB
لیجئے	لِیجِیے 	VB
لینے	لینے 	VB
لیں	لِیں 	VB
میرے	میرے	PRN
نکلتی	نِکَلْتی 	VB
نکلنی	نِکَلْنی 	VB
نکلنے	نِکَلْنے 	VB
نکلو	نِکْلو 	VB
نکلوں	نِکْلُوں 	VB
نکلیں	نِکْلِیں 	VB
نکلئے	نِکَلْیے 	VB
والوں	والوں	ADJ
والے	والے	ADJ
ڈلتا	ڈَلتا	VB
ڈلتیں	ڈَلتِیں	VB
ڈلنی	ڈَلنی	VB
ڈلو	ڈَلو	VB
ڈلوں	ڈَلوں	VB
ھیں	ھیں	VB
ہوئیے	ہوئِیے 	VB
ہوتا	ہوتا	VB
ہوتی	ہوتِی	VB
ہوتیں	ہوتِیں	VB
ہوتے	ہوتے	VB
ہونی	ہونِی	VB
ہونے	ہونے	VB