ازار	اِزَارْ
ورزیوں	وَرْزِیوْں
کشا	کُشَا
ترین	ترین
آزما	آَزْمَا
ینے	ینے
بوسیوں	بوسیوں
خورد	خُوْردْ
دہ	دَہْ
گوں	گُوںْ
کشائیوں	کشائیوں
ورڈ	وَرْڈْ
نگین	نَگِینْ
پاشی	پَاشِی
یل	یل
گزاری	گُزَارِی
بندیوں	بِنْدِیوْںْ
زدوں	زدوں
درازی	دَرَازِی
ریزیاں	ریزیاں
خور	خُورْ
فروش	فروش
آور	آَوَرْ
خر	خَرْ
پسندانہ	پسندانہ
دستی	دَسْتِی
چاری	چَارِی
صورت	صُورَتْ
بوسیاں	بوسیاں
ریزی	ریزی
فروشی	فروشی
یر	یر
نامی	نَامِی
طرازیاں	طَرَازِیَاںْ
خیزوں	خیزوں
فیہ	فیہ
بیں	بِیںْ
راں	راں
زدہ	زَدَہْ
گیر	گِیرْ
فہمیوں	فہمیوں
مند	مَنْدْ
آہنگیاں	آہنگیاں
آزمائی	آَزْمَائِی
نامیاں	نامیاں
یرا	یرا
بافیاں	بافیاں
پوش	پوشْ
بخود	بَخُودْ
درازیاں	دَرَازِیَاںْ
نامیوں	نَامِیوْں
مزاجیاں	مزاجیاں
گیریاں	گیریاں
فہمیاں	فہمیاں
بافیوں	بافیوں
وروں	وروں
پا	پَا
ریزیوں	ریزیوں
زادے	زادے
فرسا	فَرْسَا
وائز	وَائِزْ
گہ	گہ
پرستوں	پرستوں
سوزی	سوْزِی
گیریوں	گیریوں
زنی	زنی
شپ	شِپْ
کدوں	کَدوْں
نویسی	نَوِیْسِی
فہم	فہۡم
ریز	ریْزْ
اندیش	اَنْدیشْ
بند	بَنْدْ
نویس	نَوِیسْ
داروں	دَاروْںْ
خیز	خیزْ
ینہ	ینہ
پرستی	پرستی
نشین	نَشِینْ
ینی	یَنِی
کناں	کناں
تراش	تَرَاشْ
شعاری	شِعَارِی
اندازیوں	اندازیوں
یلوں	یلوں
کار	کَارْ
آہنگی	آَہَنْگِی
داز	داز
گھر	گھر
گار	گَارْ
آوروں	آوروں
بینوں	بَینوںْ
آزادی	آَزَادِی
سار	سَارْ
شار	شَارْ
کاری	کَارِی
کاریاں	کَارِیَاںْ
یا	یَا
سراؤں	سَرَاؤںْ
گاری	گاری
شکن	شِکَنْ
دار	دَارْ
بندیاں	بِنْدِیَاںْ
لوحی	لوحی
دانیوں	دانیوں
شعار	شِعَارْ
آمیزیاں	آمیزیاں
بافی	بافی
فلی	فلی
خوراکی	خُورَاکِی
انگیزی	انگیزی
آزاریوں	آزاریوں
زادی	زادی
رانیاں	رَانِیَاںْ
نگیں	نَگِیںْ
سرائیاں	سرائیاں
داران	دَارَانْ
گاہی	گاہی
نویسوں	نویسوں
زن	زَنْ
نشینی	نَشِینِی
پاشیاں	پاشیاں
فشانی	فِشَانِی
آگیں	آگیں
آمیزی	آَمیزِی
کرام	کَرَامْ
بازوں	بَازوْںْ
برداریاں	برداریاں
یرہ	یرہ
مندی	مَندِی
آہنگیوں	آہنگیوں
گاروں	گَاروْں
آفرینی	آفرینی
خیزی	خیزِی
پاشیوں	پاشیوں
وارانہ	وارانہ
دست	دَسْتْ
گروں	گُروْںْ
نمائی	نُمَائِی
نوازی	نَوَازِی
دارہ	دَارَہْ
دلی	دَلِی
خوانیوں	خوانیوں
نمائیاں	نمائیاں
بازی	بَازِی
آزاریاں	آزاریاں
نامے	نَامے
نوردی	نَوَرْدِی
دازی	دازی
نام	نَامْ
مندانہ	مندانہ
دہی	دَہِی
ریزوں	ریزوں
گزاروں	گُزَارُوںْ
سگالی	سِگَالِی
آرائیوں	آَرَائِیوْں
دادوں	دَادوْںْ
باش	بَاشْ
ویں	ویں
گزار	گُزَارْ
کنندگان	کُنِنْدْگَانْ
گوئیاں	گوئیاں
آویز	آَویزْ
دراز	دَرَازْ
گساروں	گساروں
بختیاں	بختیاں
افروز	اَفْروْز
اندازی	اَنْدَازِی
داشت	دَاشْتْ
پسندی	پَسَنْدِی
زادیوں	زادیوں
خوریوں	خوریوں
پسند	پَسَنْدْ
سرا	سِرَا
بختیوں	بختیوں
رنگی	رَنْگِی
نیس	نَیسْ
گوئیوں	گوئیوں
اندوزی	اَنْدوزِی
آمیز	آَمیزْ
سازی	سازی
آرا	آَرَا
دارانہ	دَارَانَہْ
لیواؤں	لیواؤں
خوانیاں	خوانیاں
آشام	آَشَامْ
ناکی	ناکی
پرور	پَرْوَرْ
نفسیاں	نفسیاں
دوز	دوز
نامہ	نَامَہْ
زدگی	زدگی
خوفی	خَوفِی
طراز	طَرَازْ
پسندوں	پَسَنْدوْںْ
ناکیاں	ناکیاں
فشاں	فِشَاںْ
نفسیوں	نفسیوں
یری	یری
نفس	نَفَسْ
ظرفی	ظَرْفِی
ظرفیاں	ظرفیاں
ناکیوں	ناکیوں
طرازیوں	طَرَازِیوںْ
پیما	پَیمَا
لوحیاں	لوحیاں
خیزیوں	خیزیوں
خواہ	خواہ
آرائی	آرائی
زادیاں	زادیاں
ظرفیوں	ظرفیوں
گرفتہ	گِرِفْتَہْ
آبادی	آَبَادِی
یز	یز
گری	گِرِی
تراشی	تَرَاشِی
گاہوں	گاہوں
یافتہ	یَافتَہ
سازیوں	سازیوں
خیزیاں	خیزیاں
عامہ	عامہ
لوح	لَوحْ
شماری	شُمَارِی
باختہ	بَاخْتَہْ
کاریوں	کَارِیوْں
سازیاں	سازیاں
بوسی	بوسِی
حال	حَالْ
رانی	رَانِی
خوانی	خوانی
اندیشانہ	اندیشانہ
گسار	گسار
بانی	بَانِی
شدہ	شُدَہ
بین	بَینْ
دانی	دَانِی
پزیر	پزیر
لیوا	لیوَا
گاہ	گاہ
خوار	خَواْرْ
دوار	دَوَارْ
یشہ	یشہ
فروشوں	فروشوں
گران	گران
کدہ	کَدَہْ
کدے	کَدے
افزا	اَفْزَا
پیماؤں	پیماؤں
برداریوں	برداریوں
گو	گو
نوشوں	نَوشوںْ
یلے	یلے
کشائی	کُشَائِی
کشوں	کَشوْںْ
نماں	نماں
تراشیاں	تراشیاں
فگار	فِگَارْ
مندیوں	مندیوں
نگار	نِگَارْ
کردہ	کَرْدَہْ
فشانیاں	فشانیاں
گرنی	گِرْنِی
باز	بَازْ
مندیاں	مَنْدِیَاںْ
درازیوں	درازیوں
گرافی	گَرَافِی
بخش	بَخْشْ
بختی	بَخْتِی
واڑہ	واڑہ
زادہ	زادہ
واس	وَاسْ
ستانی	سَتَانِی
داریاں	داریاں
جات	جَاتْ
یابی	یابی
لیس	لیْسْ
غرضیوں	غرضیوں
انگیزیاں	انگیزیاں
پرست	پَرَسْتْ
زدگان	زدگان
افزائی	اَفزَائِی
فگن	فِگَنْ
یات	یات
نفسی	نَفْسِی
گین	گَینْ
نگاری	نِگَارِی
خاطر	خَاطِرْ
داریوں	داریوں
اندیشوں	اَنْدیْشوْںْ
انگیز	اَنْگیزْ
خواں	خواں
گیروں	گِیروں
بدوشوں	بَدوْشوْں
ورزی	وَرْزِی
نفسوں	نَفَسوْںْ
ازم	ازم
قسمتی	قسمتی
پوشوں	پوشوْں
ناک	نَاکْ
وان	وَانْ
نما	نُمَا
اندیشیاں	اندیشیاں
کشیدہ	کَشِیدَہْ
آباد	آَبَادْ
جوئی	جُوئِی
ظرف	ظَرْفْ
کشی	کُشِی
افزائیوں	افزائیوں
غرضیاں	غرضیاں
دانوں	دَانوْںْ
اندیشی	اَنْدیشِی
رانیوں	رَانِیوْںْ
برداری	بَرْدَارِی
گھروں	گھروں
آموز	آَموزْ
گردیاں	گردیاں
کشائیاں	کشائیاں
پن	پِنْ
گساری	گساری
خوری	خورِی
آوری	آوری
پرستیوں	پرستیوں
چی	چِی
ستان	ستان
گردیوں	گردیوں
آرائیاں	آرائیاں
سگالیاں	سگالیاں
نگاریاں	نگاریاں
خانے	خَانےْ
نماؤں	نِمَاؤُںْ
دادیں	دَادیْں
دہانی	دہانی
دان	دَانْ
دانیاں	دَانِیَاںْ
بازیاں	بازیاں
مندوں	مندوں
اندوزوں	اندوزوں
فگاروں	فِگَاروْںْ
انداز	اَنْدَازْ
یت	یت
گیری	گَیرِی
بردار	بُرْدَارْ
کش	کَشْ
بازیوں	بازیوں
دوست	دوْسْتْ
یان	یان
پروری	پَرْوَرِی
آفرینیاں	آَفْرِینِیَاںْ
اندام	اَنْدَامْ
ہان	ہَانْ
مزاجی	مِزَاجِی
اندوز	اندوز
ناموں	نَاموْںْ
نگاروں	نِگَاروْںْ
گوئی	گوئی
سرائیوں	سَرَائِیوںْ
طرازوں	طرازوں
فشانیوں	فشانیوں
لی	لِی
افشاں	اَفْشَاںْ
نوازیوں	نوازیوں
شناسی	شَنَاسِی
دہانیاں	دہانیاں
واری	وَارِی
آلودہ	آَلُودَہْ
زاد	زَادْ
خانوں	خَانوْںْ
فہمی	فہۡمی
سگالیوں	سگالیوں
نگاریوں	نگاریوں
شدگان	شُدگَانْ
طرازی	طَرَازِی
بندی	بَنْدِی
باف	بَافْ
خانہ	خَانَہْ
کارانہ	کارانہ
گردانی	گَرْدَانِی
انگیزیوں	انگیزیوں
یاب	یَابْ
شناس	شَنَاسْ
گان	گان
فل	فُلْ
آفریں	آَفْرِیںْ
سوز	سوزْ
ورانہ	ورانہ
دستوں	دَسْتوْںْ
ورزیاں	ورزیاں
آمیزیوں	آمیزیوں
یچوں	یچوں
تی	تی
ہڈ	ہُڈْ
بدوش	بَدوْشْ
کن	کِنْ
کاروں	کَاروںْ
گیں	گِیںْ
ور	وَرْ
یلا	یلا
سنج	سَنْجْ
نوازیاں	نوازیاں
سرائی	سَرَائِی
ایبل	ایبَلْ
داری	دَارِی
شکنی	شکنی
مزاجیوں	مزاجیوں
غرضی	غَرَضِی
اندیشیوں	اندیشیوں
تراشیوں	تراشیوں
زادوں	زادوں
گردی	گَردِی
کنندہ	کُنِنْدَہْ
وار	وَارْ
وانا	وَانَا
دہانیوں	دہانیوں
آزار	آَزَارْ
خوروں	خَوروں
گر	گُرْ
دل	دَلْ